$$$ exec p1 : [./filler]
Plateau 15 17:
    01234567890123456
000 .................
001 .................
002 .................
003 .................
004 .................
005 .................
006 ....OO...........
007 .....o...........
008 .....o...........
009 .................
010 .................
011 ...........XXX...
012 .................
013 .................
014 .................
Piece 3 6:
.****.
**....
*.....
